[10 5]
XXXXXXXXXX
XH....RD.X
X..... ..X
X.....m..O
XXXXXXXXXX
