[10 10]
XXXXXXXXXX
XH.......X
X.      .X
X..xxxx  X
X.x. ..x X
X.x. A   X
X.x. ..x X
X..xxxx. X
X....... X
XXXXXXXXXX
