[10 7]
XXXXXXXXXX
XH....RD.X
X..... ..X
X.....m..O
X..... ..X
X........X
XXXXXXXXXX
