[10 7]
1
XXXXXXXXXX
XH....R..X
X..... ..X
X.....m..O
X..... ..X
X........X
XXXXXXXXXX
