[10 10]
5
XXXXXXXXXX
XH.x.....X
X. x    .X
X.xxxxxx X
X.x. ..x X
X.x. A   X
Xxx. ..x X
X.xxxxxx X
X....... O
XXXXXXXXXX
